langue:anglais
lethal/deadly=mortel
a fit=une crise
to gasp=s'asphyxier
to publicize/to advertise=faire de la publicité
the awareness=la prise de conscience
to tend to=tendre à
to have a tendency=avoir tendance
wise=sage
wisdom=sagesse
awkward=maladroit
the crocks=la vaisselle ébréchée
weird/odd/strange=bizarre
to tear, tore, torn=déchirer
the oilcloth=la toile cirée
stale=rassis
a stocking=un collant
efficient/effective=efficace
the realm of=le royaume de/le monde de
a fad=une tendance/une mode
to wag=remuer
the sins=les pêchés
the sinner=le pêcheur/celui qui a commis un pêché
vacuum cleaner=aspirateur
healthy/wholesome=sain
the newly weds=les jeunes mariés
word to mouth=bouche à oreille
a hoax=une supercherie
the attic=le grenier
a lay-off=un licenciement
entertainment=divertissement
to bathe=se baigner
the plague=la peste
a physicist=un physicien
a physician=un médecin
