aus+D stammen=être originaire de
türkischstämmig=d\'origine turque
die Wurzel(n)=la racine
ungerecht=injuste
empfinden=ressentir/éprouver
diskriminieren=discriminer
sich benachteiligt fühlen=se sentir désavantagé/se sentir défavorisé
geistig=intellectuel/spirituel
körperlich=corporel
der Schleier=le voile
unverschämt=insolent         
die Gotteslästerung=le blasphème
die Autonomie=l\'autonomie
A heiraten=épouser
die Braut=la fiancée
der Bräutigam=le fiancé
die Hürde(n)=l\'obstacle
aufnehmen=accueillir
das Aufnahmeland=le pays d\'accueil
beherrschen=maîtriser
die Beherrschung=la maîtrise
das Sagen haben=commander
der Fleck(e)/der Fleck(en)=la tache
ausbleiben=ne pas se produire
sich setzen=s\'asseoir
sitzen(er sitzt, er saß, er hat gesessen)=être assis
die Schweiz=la Suisse
der Schweiß=la sueur
verfolgen=persécuter
ausgebildet=diplômé
die Ausgebildung=la formation
der Tischler=le menuisier
der Dolmetscher=l\'interprète
der Übersetzer=le traducteur
beschränkt=borné/limité
der Glaube/der Glauben=la croyance
pünktlich=ponctuel
entschlossen=décidé
das Vorurteil=le préjugé
eine vorgefaßte Meinung=une idée préconçue
ehrlich=honnête
die Ehre=l\'honneur
schlagfertig=du tac au tac
gastfreundlich=hospitalier
die Gastfreundlichkeit=l\'hospitalité
höflich/glatt=poli
das Dorf(¨er)=le village
der Artist(en,en)=l\'artiste de cirque
der Künstler=l\'artiste