der Staat(en)=l'Etat
staatlich=gouvernemental/d'Etat
das Staatsgebet(e)=le territoire national
die Staatsangehörigkeit=la citoyenneté/la nationalité
der Bürger(-)=le citoyen
der Mitbürger(-)=le concitoyen
die Nation(en)=la nation
national=national
das Volk(¨er)=le peuple
die Heimat=la petite patrie
das Vaterland(¨er)=la patrie
das Ausland=les pays étrangers
der Ausländer(-)=l'étranger
die Ausländerfeindlichkeit=la xénophobie
ausländerfeindlich=xénophobe
die Verfassung=la constitution
das Grundgesetz=la loi fondamentale
das System(e)=le système
die Gewaltenteilung=la séparation des pouvoirs
der Rechtsstaat(en)=l'Etat de droit
die Demokratie(n)=la démocratie
der Demokrat(en,en)=le démocrate
demokratisch=démocratique
parlamentarisch=parlementaire
die Freiheit(en)=la liberté
die Regierungsform(en)/das Regime=le régime
die Republik(en)=la république
die Diktatur(en)=la dictature
der Totalitarismus=le totalitarisme
totalitär=totalitaire
das Exil=l'exil
der Flüchtling(e)=le réfugié
der Asylant=le demandeur d'asile
der deutsche Nationalfeiertag=la fête nationale allemande
ausgebürgert werden=être déchu de sa nationalité
auswandern=émigrer
flüchten=se réfugier
ins Exil gehen=vivre en exil
die Politik=la politique
der Politiker(-)=l'homme politique
politisch=politique
der Gegner(-)=l'opposant/l'adversaire
der Feind(e)=l'ennemi
beliebt/populär=populaire
unbeliebt=impopulaire
umstritten=controversé
glaubwürdig=crédible
korrupt=corrompu
die Korruption(s)=la corruption
das Parlament(e)=le parlement
die Nationalversammlung=l\'assemblée nationale
die Nationalversammlung auflösen=dissoudre l\'assemblée nationale
der Senat=le Sénat
das Abgeordnetenhaus=la chambre des députés
der Abgeordnete(adj.subs.)=le député
die Fraktion(en)=le groupe parlementaire
tagen=siéger
die Sitzung=la réunion/la séance
ein Gesetz besprechen=discuter une loi
ein Gesetz annehmen=adopter une loi
ein Gesetz abnehmen=repousser une loi
das Mitglied(er)=le membre
die Partei(en)=le parti
gründen=fonder
die Strömung=le courant
die Weltanschauung(en)=la vision du monde/la conception du monde
die Ideologie(n)=l\'idéologie
gemäßigt=modéré
liberal=libéral
radikal=radical
der Faschismus=le fascisme
der Faschist(en,en)=le fasciste
verurteilen=condamner
der Neonazi(s)=le néonazi/le néo-nazi
neonazistisch=néonazi/néo-nazi
rechtsradikal=d\'extrême droite
die äußerte Rechte=l\'extrême droite
die Rechte=la droite
die Rechtspartei(en)=le parti de droite
konservativ=conservateur
der Zentrist(en,en)=le centriste
fortschrittlich/progressiv=progressiste
die Linke(n)=la gauche
die Linkspartei(en)=le parti de gauche
sozialistisch=socialiste
der Sozialist(en,en)=le socialiste
der Sozialismus(en)=le socialisme
kommunistisch=communiste
der Kommunist(en,en)=le communiste
der Kommunismus=le communisme
der Linksextremus=le gauchisme
der Linksextremist(en,en)/der Linksradikale(adj.subs.)=le gauchiste
der Grüne(adj.subs.)=le vert
linksgesinnt sein=être de gauche
in eine Partei eintreten/einer Partei beitreten=adhérer à un parti
politisch aktiv sein/politisch engagiert sein=militer politiquement
das aktive Parteimitglied=le militant politique
aus der Partei austreten=quitter le parti
aus der Partei ausgeschlossen werden=être exclu du parti
in der Opposition bleiben/in der Opposition verharren=rester dans l\'opposition
einen neuen Kurs einschlagen=changer de cap
in einen Finanzskandal verwickelt sein=être mêlé à un scandale financier
verwickelt sein=être impliqué
aus politischen Gründen=pour des raisons politiques
die Wahl(en)=l\'élection
jemanden wählen=voter pour quelqu\'un
gegen etwas stimmen=voter contre quelque chose
der Wahlkampf(¨e)/die Wahlkampagne=la campagne électorale
fair=loyal
unfair=déloyal
demagogisch=démagogique
das Wahllokal(e)=le bureau de vote
der Wahlzettel(-)=le bulletin de vote