der Kreuzzug(¨e)=la croisade
die Religion=la religion
der Papst=le pape
der Bischof(¨e)=l'évêque
der Erzbischof(¨e)=l'archevêque
der Herzog(¨e)=le duc
der Erzherzog(¨e)=l'archiduc
der Muslim=le musulman
der Heide(n,n)=le païen
die Urkunde(n)/das Dokument(e)=le document
verteidigen=défendre
die Verteidigung=la défense
die Ursache(n)=la cause
die Gewalt=la violence
taufen=baptiser
ursprünglich=à l'origine
erobern=conquérir
die Urgeschichte=la préhistoire
das Kreuz(e)=la croix
das Ziel(e)=le but
der Kreuzfahrer=le croisé
verletzt=blessé
der Verletzte=le blessé
der Ritter=le chevalier
unterstützen=soutenir
der Fürst=le prince
der Adlige=le noble
umwandeln=transformer
Geld schlagen=battre monnaie
das Gebet=la prière
deutschsprachig=germanophone
die Regierung=le gouvernement
die Kirche=l'église
die Zelle(n)=la cellule
das Feld(er)=le champ
der Luxus=le luxe
die Hierarchie=la hiérarchie
das Turnier(e)=le tournoi
