verkünden=annoncer
die Auseinandersetzung=le conflit
die Sackgasse=le cul-de-sac
Pleite gehen/Konkurs machen=faire faillite
der Bergmann=le mineur
buddeln/graben=creuser
trocken=sec
die Leitung=le tuyau rigide
der Schlauch(¨e)=le tuyau souple
überreichen=tendre
nass=mouillé
schmutzig=sale
bewundern/anhimmeln=admirer
die Bewunderung=l'admiration
das Schweigen=le silence
die Stille/die Ruhe=le calme
die Scham=la honte
sich schämen=avoir honte
empört=indigné
feige sein=être lâche
die Feigheit=la lâcheté
hell=clair
leicht/einfach=facile
die dritte Welt=le tiers monde/le tiers-monde
der Beschwerdebrief=la lettre de protestation
die Zusammenhalt=la cohésion
der Alltag=le quotidien
der Aspekt(e)=l'aspect
der Tal=la vallée
die öffentlichen Verkehrsmittel=les transports en commun
der Muskelkater=la crampe
einen Kater haben=avoir la gueule de bois
einen Beruf ausüben=exercer un métier
die Gleichheit=l'égalité
der Absender=l'expéditeur
die Vollbeschäftigung=le plein emploi
die Arbeitslosigkeit=le chômage
die Befürchtung=l'appréhension
bezahlen=rémunérer
der Lohn(¨e)=le salaire versé par l'Etat
das Gehalt(¨er)=le salaire versé par une entreprise
die Verfassung=la constitution
die Tendenz=la tendance
sinken=diminuer
steigen=augmenter/monter
prononcer=aussprechen
se contenter de=sich mit+D begnügen
muet de stupéfaction=sprachlos
le narrateur=der Erzähler
mettre en question=in Frage stellen
indifférent=gleichgültig
égocentrique/égoïste=ichbezogen/egoistisch
désirer=sich nach+D sehnen
surpris=überrascht
stupéfait=verblüfft
déconcerté=verdutzt
D gehorchen=obéir
gehorsam=obéissant
unterzeichnen=signer 
sich weigern=refuser  
die Versammlung=l'assemblée
sich versammeln=se rassembler 
der Treffpunkt=le lieu de rendez-vous
vertreten=représenter
der Genosse(n,n)=le camarade communiste
der Kumpel=le pote    
ausschließen=exclure  
empfinden=ressentir
verängstigt=apeuré 
bergen=sauver
die Ironie=l'ironie
kritisch=critique
die Vollendung=la perfection
auslachen/über+A spotten/sich lustig über+A machen=se moquer
ins Lächerliche ziehen=tourner en ridicule 
verteidigen=défendre
die Debatte=le débat
betiteln=intituler  
schildern/beschreiben=décrire  
umgekehrt=inverse 
die Spur(en)=la trace  
heutig=présent 
die Flucht(en)=la fuite
der Flüchtling(e)=le réfugié  
das Zuchthaus=l'établissement pénitentiaire 
D den Rücken kehren=tourner le dos
ergreifen=saisir/arrêter 
der Fluchtversuch=la tentative de fuite  
erfinderisch=inventif
der Einfall=l'idée soudaine
einfallsreich=ingénieux 
unterirdisch=souterrain 
außerirdisch=extraterrestre
der Fluchthelfer=le passeur  
die Rezension=la critique
niederschreiben=coucher sur le papier
zur Verfügung stellen=mettre à disposition
zur Verfügung stehen=être à disposition
darstellen=présenter/représenter
sich+A vorstellen=se présenter
sich+D vorstellen=s\'imaginer
verursachen=causer
das Unendliche=l\'infini
das Viertel=le quart/le quartier
die Normenerhöhung= l\'augmentation des normes
die Landwirtschaft=l\'agriculture
die Errichtung=la construction
der Stacheldraht=le fil barbelé
der Todesstreifen=le couloir de la mort
berüchtigt=à la réputation sulfureuse
das Unterfangen=l\'entreprise
kränken=blesser moralement
blamiert=vexé
ausfeilen=perfectionner
die Genehmigung=l\'accord
schildern=décrire